
F255, 200, 0

C 255,30,30




    NO    maps/textures/no_texture.xpm
SO   maps/textures/so_texture.xpm



  WE maps/textures/we_texture.xpm



EA maps/textures/ea_texture.xpm

         1111111111111111111111111
         10000000000000000000000011111
11111111110000000000000000000000000001
10000000000000000S00000000001111111111      
10000000000000000000000000001111
1000000001111111000000000000000111
1000000001     1000000000000000111
1000000001     1000000000000000001
1000000001     1000000000000000111
1000000001     10000000000000001111111111111111111
10000000011111110000000000000000000000000000000001
10000000000000000000000000000000000000000000000001
10000000000000000000000000000000000000000000000001
10000000000000000000000000000000000000000000000001
11111111111111111111111111111111111111111111111111
