NO maps/textures/no_texture.xpm
SO maps/textures/so_texture.xpm
WE maps/textures/we_texture.xpm
EA maps/textures/ea_texture.xpm
F , ,0,0,255
C 255,0,0

1111
10N1
1111
