NO./textures/north_wall.xpm



SO      ./textures/south_wall.xpm
WE                      ./textures/west_wall.xpm


EA ./textures/east_wall.xpm
F 125,200,10
C    140,125,10





      

11111111
10000001
10010001

10010101
101N0001
11111111