NO ./textures/wall1.xpm
SO ./textures/wall2.xpm
WE ./textures/wall3.xpm
EA ./textures/wall5.xpm
F 220,100,0
C 63,76,107

1111111111111111111111111111111111111111111111111111
1000000000000000000000000000000000000000000000000001
1011111111111111111111111111111111111111111111111101
1010000000000000000000000000000000000000000000000101
1010111111111111111111111111111111111111111111110101
1010100000000000000000000000000000000000000000000101
1010101111111111111111111111111111111111111111110101
1010101000000000000000000000000000000000000000000101
1010101011111111111111111111111111111111111111110101
1010101010000000000000000000000000000000000000000101
1010101010111111111111111111111111111111111111110101
1010101010100000000000000000000000000000000000000101
1010101010101111111111111111111111111111111111110101
1010101010101000000000000000000000000000000000000101
1010101010101011111111111111111111111111111111110101
1010101010101010000000000000000000000000000000000101
1010101010101010111111111111111111111111111111110101
1010101010101010100000000000000000000000000000000101
1010101010101010101111111111111111111111111111110101
1010101010101010101000000000000000000000000000000101
1010101010101010101011111111111111111111111111110101
1010101010101010101010000000000000000000000000000101
1010101010101010101010111111111111111111111111110101
1010101010101010101010100000000000000000000000000101
1010101010101010101010101111111111111111111111110101
1010101010101010101010101000000000000000000000000101
1010101010101010101010101011111111111111111111110101
1010101010101010101010101010000000000000000000000101
1010101010101010101010101010111111111111111111110101
1010101010101010101010101010100000000000000000000101
1010101010101010101010101010101111111111111111110101
1010101010101010101010101010101000000000000000000101
1010101010101010101010101010101011111111111111110101
1010101010101010101010101010101010000000000000000101
1010101010101010101010101010101010111111111111110101
1010101010101010101010101010101010100000000000000101
1010101010101010101010101010101010101111111111110101
1010101010101010101010101010101010101000000000000101
1010101010101010101010101010101010101011111111110101
1010101010101010101010101010101010101010000000000101
1010101010101010101010101010101010101010111111110101
1010101010101010101010101010101010101010100000000101
1010101010101010101010101010101010101010101111110101
1010101010101010101010101010101010101010101000000101
1010101010101010101010101010101010101010101011110101
1010101010101010101010101010101010101010101010000101
1010101010101010101010101010101010101010101010110101
1010101010101010101010101010101010101010101010100101
1010101010101010101010101010101010101010101010101101
1000000000000000000000000000000000000000000000000001
1111111111111111111111111111111111111111111111111111