NO maps/textures/no_texture.xpm
SO maps/textures/so_texture.xpm
WE maps/textures/we_texture.xpm
EA maps/textures/ea_texture.xpm

F 164,169,20
C 153,204,255

    11
   1001
  100000
 1000N001
1111111111
