NO maps/textures/no_texture.xpm
SO maps/textures/so_texture.xpm
EA maps/textures/ea_texture.xpm
WE maps/textures/we_texture.xpm

F 64,109,78
C 212,224,224


  11111111111
  10000000001
  10111111101
  1N1     101
  101     101
  10111111101
  10000000001
  11111011111
      101        
111111101111
100100000001
100100000001
100000000001
10010000000111
10010000000001
11111111111111