NO    maps/textures/no_texture.xpm
SO   maps/textures/so_texture.xpm
WE maps/textures/we_texture.xpm
EA maps/textures/ea_texture.xpm

C 135,206,235
F 45,33,27

1111111111111111111111
1N00000100000000000001
1000000100000000000001
1000000100000000100001
1000000000000000100001
1000000000000000100001
1111111111111111111111
