
NO    maps/textures/no_texture.xpm
SO   maps/textures/so_texture.xpm
WE maps/textures/we_texture.xpm
EA maps/textures/ea_texture.xpm

C 135,206,235
F 45,33,27

1111111111111111111111111111111111111
1011000000000000100000000000000000001
1001001001111111111111111111111110111
1001101010000000000000000000000000001
1000001010011111101111110011100111111
1111101000010000000000010000000000001
1000001111111110000000010000000000001
1001001000000000000000010000100000001
1000001111111111111100011100111110111
1011011000000000010000000000000000001
1011000010111110101010110110110011111
1000110010000000101110000000000000001
1010010110110111100000000000000101001
1111000100000000001011101101110101001
1011111111111011000010100000100000101
1000000000000000000000111110001111001
1011000010111110101010110110110011111
1000110010000000101110000000000000001
1010010110110111100000000000000101001
1111000100000000001011101101110101001
1011111111111011000010100000100000101
1000000000000000000000111110001111001
1011011000000000010000000000000000001
1011000010111110101010110110110011111
1000110010000000101110000000000000001
1010010110110111100000000000000101001
1111000100000000001011101101110101001
1W11111111111011000010100000100000101
1000000000000000000000111110001111001
1111111111111111111111111111111111111