NO maps/textures/no_texture.xpm
SO maps/textures/so_texture.xpm
WE maps/textures/we_texture.xpm
EA maps/textures/ea_texture.xpm

F 164,169,20
C 153,204,255

   1111  11111111
  110011 10000001
 1100001111000011
11000N0011110011
1111111111 1111
